20 20

2.0 2.0 45.0

2 2 2 2 2 2 2 2 2 2 2 2 2 2 2 2 2 2 2 2
2 0 0 0 0 0 0 0 0 0 0 0 0 0 0 0 0 0 0 2
2 0 0 0 0 0 0 0 0 0 0 0 0 0 0 0 0 0 0 2
2 0 0 3 3 0 0 3 3 0 0 3 3 0 0 3 3 0 0 2
2 0 0 3 3 0 0 3 3 0 0 3 3 0 0 3 3 0 0 2
2 0 0 0 0 0 0 0 0 0 0 0 0 0 0 0 0 0 0 2
2 0 0 0 0 0 0 0 0 0 0 0 0 0 0 0 0 0 0 2
2 0 2 0 0 1 1 1 1 1 1 1 1 1 1 1 1 0 0 2
2 0 0 0 0 1 0 0 0 0 0 0 0 0 0 0 0 0 0 2
2 0 3 0 0 1 0 0 0 0 0 0 0 0 0 0 0 0 0 2
2 0 0 0 0 1 0 0 1 1 1 1 1 1 1 1 1 1 1 2
2 0 1 0 0 1 0 0 1 0 0 0 0 0 0 0 0 0 0 2
2 0 0 0 0 1 0 0 1 0 0 0 0 0 0 0 0 0 0 2
2 0 2 0 0 1 0 0 1 0 0 0 3 3 3 3 3 0 0 2
2 0 0 0 0 1 0 0 1 0 0 0 3 0 0 0 0 0 0 2
2 0 3 0 0 1 0 0 1 0 0 0 3 0 0 0 0 0 0 2
2 0 0 0 0 1 0 0 1 0 0 0 3 3 3 3 3 0 0 2
2 0 1 0 0 1 0 0 0 0 0 0 0 0 0 0 0 0 0 2
2 0 0 0 0 1 0 0 0 0 0 0 0 0 0 0 0 0 0 2
2 2 2 2 2 2 2 2 2 2 2 2 2 2 2 2 2 2 2 2

75 75 75
25 25 25

1 255 0 0
2 0 255 0
3 0 0 255
